12 34 24 1 41 42 5 1 6 8 24 54 13 53
12 43 13 41 1 4 7 8 13 23
12 34 24 1 41 42 5 1 6 8 24 54 13 53
12 43 13 41 1 4 7 8 13 2312 34 24 1 41 42 5 1 6 8 24 54 13 53
12 43 13 41 1 4 7 8 13 2312 34 24 1 41 42 5 1 6 8 24 54 13 53
12 43 13 41 1 4 7 8 13 2312 34 24 1 41 42 5 1 6 8 24 54 13 53
12 43 13 41 1 4 7 8 13 2312 34 24 1 41 42 5 1 6 8 24 54 13 53
12 43 13 41 1 4 7 8 13 2312 34 24 1 41 42 5 1 6 8 24 54 13 53
12 43 13 41 1 4 7 8 13 2312 34 24 1 41 42 5 1 6 8 24 54 13 53
12 43 13 41 1 4 7 8 13 2312 34 24 1 41 42 5 1 6 8 24 54 13 53
12 43 13 41 1 4 7 8 13 2312 34 24 1 41 42 5 1 6 8 24 54 13 53
12 43 13 41 1 4 7 8 13 2312 34 24 1 41 42 5 1 6 8 24 54 13 53
12 43 13 41 1 4 7 8 13 23